œp	[øp]
zginmdim	[zgɛ̃mdim]
èRbip	[ɛʁbip]
ondmék	[ɔ̃dmek]
rijdailééch	[χiʒdaileeʃ]
onninèTH	[ɔ̃nɛ̃ɛð]
jéoumpéblabaaRvèr	[ʒeumpeblabaaʁvɛχ]
jzinunokpodim	[ʒzɛ̃ynokpodim]
rsulifpékTHéœnmav	[χsylifpekðeønmav]
intanjanir	[ɛ̃tanʒɑ̃iχ]
ajvonvnéchagnéognaannmanakrén	[aʒvɔ̃vneʃagneognaɑ̃nmɑ̃akχen]
oup	[up]
ét	[et]
r	[χ]
chèispèlnètoRipéf	[ʃɛispɛlnɛtoʁipef]
onm	[ɔ̃m]
nsœmaén	[nsømaen]
èétèœvéd	[ɛetɛøved]
utéèmkapénoutmonftonvbiraTH	[yteɛmkapenutmɔ̃ftɔ̃vbiχað]
èr	[ɛχ]
nœRménonth	[nøʁmenɔ̃θ]
mavèg	[mavɛg]
mdimsèf	[mdimsɛf]
gagnodlèlfièkakrunèartéoupup	[gagnodlɛlfiɛkakχynɛaχteupyp]
onk	[ɔ̃k]
élènébvaTHépatèèf	[elɛnebvaðepatɛɛf]
bvœtlin	[bvøtlin]
THkonf	[ðkɔ̃f]
k	[k]
fœrlinikébosaathèbozmèmtèriR	[føχlɛ̃ikebosaaθɛbozmɛmtɛχiʁ]
ouvnanRaaf	[uvnɑ̃ʁaaf]
onch	[ɔ̃ʃ]
achèm	[aʃɛm]
ftudRéœk	[ftydʁeøk]
n	[n]
op	[op]
THinrichméœs	[ðinχiʃmeøs]
méounbanfèrsèRdéRounladaRnataèmétrochlédmétronRèèch	[meunbɑ̃fɛχsɛʁdeʁunladaʁnataɛmetχoʃledmetχɔ̃ʁɛɛʃ]
oubaér	[ubaeχ]
fkoumédèz	[fkumedɛz]
intig	[ɛ̃tig]
nsèm	[nsɛm]
usof	[ysof]
gakimaénzonréésochkamonkèknér	[gakimaenzɔ̃χeesoʃkamɔ̃kɛkneχ]
ougmougnanèr	[ugmugnɑ̃ɛχ]
ourœdlitaézmonf	[uχødlitaezmɔ̃f]
jmij	[ʒmiʒ]
dzouR	[dzuʁ]
œb	[øb]
zèsérpasétkial	[zɛseχpasetkial]
iTHèt	[iðɛt]
kouRiarutkaapkonlnaknéouktout	[kuʁiaχytkaapkɔ̃lnakneuktut]
p	[p]
bgaiv	[bgaiv]
œchlaazonl	[øʃlaazɔ̃l]
fkonchag	[fkɔ̃ʃag]
zès	[zɛs]
chèun	[ʃɛyn]
kfob	[kfob]
pésménkœlbéonvdéamumséér	[pesmenkølbeɔ̃vdeamymseeχ]
ouf	[uf]
éèdoutœlatéébgilrinœnchaaftérpèazgénbènagagal	[eɛdutølateebgilχɛ̃ønʃaafteχpɛazgenbɛnagagal]
japinfan	[ʒapinfan]
THpak	[ðpak]
ouch	[uʃ]
pnéj	[pneʒ]
œn	[øn]
t	[t]
gjunrèchnip	[gʒynχɛʃnip]
kubRèazèmfalbanb	[kybʁɛazɛmfalbɑ̃b]
thnés	[θnes]
unTHètsinœfiéfiiTHonvnupful	[ynðɛtsɛ̃øfiefiiðɔ̃vnypfyl]
anfnèèrpaknoupnarfoukégméTHouf	[ɑ̃fnɛɛχpaknupnaχfukegmeðuf]
anRmarœvainvœdét	[ɑ̃ʁmaχøvaɛ̃vødet]
v	[v]
ongèm	[ɔ̃gɛm]
lrimséus	[lχimseys]
gèsiaRlonèptèmvélor	[gɛsiaʁlonɛptɛmveloχ]
smirèablipfonsléf	[smiχɛablipfɔ̃slef]
zasèan	[zasɛan]
ifmétanéèbèapkièt	[ifmetaneɛbɛapkiɛt]
b	[b]
rmarpim	[χmaχpim]
lokpinonr	[lokpinɔ̃χ]
inrèanch	[ɛ̃χɛɑ̃ʃ]
orèazmubèpègnépfèdœfparunfinospanchéémchanémchél	[oχɛazmybɛpɛgnepfɛdøfpaχynfinospɑ̃ʃeemʃɑ̃emʃel]
èTH	[ɛð]
or	[oχ]
jnèf	[ʒnɛf]
èuroTHnèèmaRéèzdézRinéznounbièznaTHménbaRmœm	[ɛyχoðnɛɛmaʁeɛzdezʁɛ̃eznunbiɛznaðmenbaʁmøm]
tranp	[tχɑ̃p]
ponvziikiRanTH	[pɔ̃vziikiʁɑ̃ð]
tingik	[tɛ̃gik]
onrnèn	[ɔ̃χnɛn]
éTHafpuf	[eðafpyf]
var	[vaχ]
afaèRthaértèn	[afaɛʁθaeχtɛn]
aranknèch	[aχɑ̃knɛʃ]
our	[uχ]
onTH	[ɔ̃ð]
mkabzégèdgioukièrnètoupèpidgat	[mkabzegɛdgiukiɛχnɛtupɛpidgat]
gmès	[gmɛs]
ouzorèbézloubonksar	[uzoχɛbezlubɔ̃ksaχ]
éènpaaranb	[eɛnpaaχɑ̃b]
jnond	[ʒnɔ̃d]
onTHtèvèdlék	[ɔ̃ðtɛvɛdlek]
znèzdafœn	[znɛzdaføn]
déichranchnœfpèdisnis	[deiʃχɑ̃ʃnøfpɛdisnis]
ud	[yd]
farlèbRor	[faχlɛbʁoχ]
thniidlirlanrlaèTH	[θniidliχlɑ̃χlaɛð]
innbif	[ɛ̃nbif]
ithlœv	[iθløv]
srèlmètlèflaèp	[sχɛlmɛtlɛflaɛp]
fich	[fiʃ]
RingRaakam	[ʁɛ̃gʁaakam]
èivèt	[ɛivɛt]
fmèkéœv	[fmɛkeøv]
anpéorkèkoutèojgat	[ɑ̃peoχkɛkutɛoʒgat]
jongmanchéd	[ʒɔ̃gmɑ̃ʃed]
jméét	[ʒmeet]
ék	[ek]
if	[if]
anbdikan	[ɑ̃bdikan]
ukéouRéchkaagaér	[ykeuʁeʃkaagaeχ]
nœtrèont	[nøtχɛɔ̃t]
usapèanTH	[ysapɛɑ̃ð]
fœginaRlanlonzbèminbènètléit	[føgɛ̃aʁlɑ̃lɔ̃zbɛmɛ̃bɛnɛtleit]
baèb	[baɛb]
l	[l]
fméérsaéf	[fmeeχsaef]
lèén	[lɛen]
kfœsèch	[kføsɛʃ]
THons	[ðɔ̃s]
nœslèfrinnrout	[nøslɛfχɛ̃nχut]
bongalmifpénoRèk	[bɔ̃galmifpenoʁɛk]
m	[m]
rchéchétadzoun	[χʃeʃetadzun]
ch	[ʃ]
ongdénduRmév	[ɔ̃gdendyʁmev]
aTHiRamrén	[aðiʁamχen]
anr	[ɑ̃χ]
oufnœsav	[ufnøsav]
ntéd	[nted]
tkéanp	[tkeɑ̃p]
vofponvœdarlébgéf	[vofpɔ̃vødaχlebgef]
oTHougéan	[oðugean]
R	[ʁ]
œt	[øt]
fnikpaéch	[fnikpaeʃ]
onpén	[ɔ̃pen]
éonsnénmaèk	[eɔ̃snenmaɛk]
tikarouch	[tikaχuʃ]
lTHékTHasaRdédonkonRèanbgèl	[lðekðasaʁdedɔ̃kɔ̃ʁɛɑ̃bgɛl]
olœpkopiapkakélfouch	[oløpkopiapkakelfuʃ]
kliinbériTHsus	[kliɛ̃beχiðsys]
atkéonpfubnésloubgonvœjonfonn	[atkeɔ̃pfybneslubgɔ̃vøʒɔ̃fɔ̃n]
THnèœn	[ðnɛøn]
anab	[ɑ̃ab]
lnadéanitmiémkandapias	[lnadeanitmiemkɑ̃dapias]
mjènranRthaèchnéf	[mʒɛnχɑ̃ʁθaɛʃnef]
dénzèfnék	[denzɛfnek]
ong	[ɔ̃g]
kak	[kak]
thlotpaanpoTHséékronmœfTHèonpaéf	[θlotpaanpoðseekχɔ̃møfðɛɔ̃paef]
œnpoth	[ønpoθ]
rmérsaèfréoufrantTHéoup	[χmeχsaɛfχeufχɑ̃tðeup]
œrmèl	[øχmɛl]
TH	[ð]
unéiR	[yneiʁ]
onbataséèf	[ɔ̃bataseɛf]
schènopnœfanéTHmigléRlèmthœgéféœpondvarfaéfontrag	[sʃɛnopnøfɑ̃eðmigleʁlɛmθøgefeøpɔ̃dvaχfaefɔ̃tχag]
THtééf	[ðteef]
aR	[aʁ]
knipnéésTHamfègirtéfréèrlaabgég	[knipneesðamfɛgiχtefχeɛχlaabgeg]
œnsouTH	[ønsuð]
chtéitlour	[ʃteitluχ]
thèsronr	[θɛsχɔ̃χ]
aloubamèchœsnénit	[alubamɛʃøsnenit]
mvaR	[mvaʁ]
ougminasnitfèlRèœTHmaém	[ugmɛ̃asnitfɛlʁɛøðmaem]
rnègonf	[χnɛgɔ̃f]
Rainamléspapféktandbèn	[ʁainamlespapfektɑ̃dbɛn]
s	[s]
pènpèvmèrnafœfkonnbongdifnavop	[pɛnpɛvmɛχnaføfkɔ̃nbɔ̃gdifnavop]
g	[g]
dléblaRébéfrœk	[dleblaʁebefχøk]
jènbaap	[ʒɛnbaap]
gdaraféankamsoréanfkanr	[gdaχafeankamsoχeɑ̃fkɑ̃χ]
lTHafronloukuk	[lðafχɔ̃lukyk]
opœponlkœfantœmèf	[opøpɔ̃lkøfɑ̃tømɛf]
ralébundèèsèRlaéfpènpapnichnas	[χalebyndɛɛsɛʁlaefpɛnpapniʃnas]
mRœgthémfoulgibjép	[mʁøgθemfulgibʒep]
jaèrsousiéksènaRvounjirtég	[ʒaɛχsusieksɛnaʁvunʒiχteg]
thèk	[θɛk]
bèr	[bɛχ]
THiR	[ðiʁ]
THfortiél	[ðfoχtiel]
bvink	[bvɛ̃k]
ér	[eχ]
éonndig	[eɔ̃ndig]
thmol	[θmol]
dmènRaf	[dmɛnʁaf]
éér	[eeχ]
paRét	[paʁet]
z	[z]
kantkas	[kɑ̃tkas]
ibRanèr	[ibʁɑ̃ɛχ]
knaivnén	[knaivnen]
vajbonk	[vaʒbɔ̃k]
èèdéèvgénlésréoudar	[ɛɛdeɛvgenlesχeudaχ]
avaètrœvaèfiRaaprutèRèopalaf	[avaɛtχøvaɛfiʁaapχytɛʁɛopalaf]
d	[d]
tkilgèkèègèthRèndèig	[tkilgɛkɛɛgɛθʁɛndɛig]
am	[am]
ul	[yl]
lœnlék	[lønlek]
gRégœgnéanpœg	[gʁegøgneɑ̃pøg]
éfléourtaf	[efleuχtaf]
ir	[iχ]
ur	[yχ]
chaétchuTH	[ʃaetʃyð]
gvunanzid	[gvynɑ̃zid]
blianm	[bliɑ̃m]
oumlèp	[umlɛp]
dlèrag	[dlɛχag]
oRlœpnœk	[oʁløpnøk]
inènrivéibliuzvékfonnzèanréifonRinlénaRméan	[ɛ̃ɛnχiveibliyzvekfɔ̃nzɛanχeifɔ̃ʁɛ̃lenaʁmean]
dézitèat	[dezitɛat]
riank	[χiɑ̃k]
gthaébiizindiRniœthaaltètèélèg	[gθaebiizindiʁniøθaaltɛtɛelɛg]
usfurtol	[ysfyχtol]
pizèflègamfazbéèrém	[pizɛflɛgamfazbeɛχem]
anTHir	[ɑ̃ðiχ]
èrochfakéoubnanmvèTHièrsaifkémouz	[ɛχoʃfakeubnɑ̃mvɛðiɛχsaifkemuz]
adgœbguk	[adgøbgyk]
THtèœnogjapidlœtmœf	[ðtɛønogʒapidløtmøf]
èérfénansnant	[ɛeχfenɑ̃snɑ̃t]
ranmtuk	[χɑ̃mtyk]
inousrérfans	[ɛ̃usχeχfɑ̃s]
zmour	[zmuχ]
èn	[ɛn]
inlrœvèéchréél	[ɛ̃lχøvɛeʃχeel]
lam	[lam]
tpaanlèèzlal	[tpaɑ̃lɛɛzlal]
ég	[eg]
THathèidaRziinmnonb	[ðaθɛidaʁziɛ̃mnɔ̃b]
aatriœrkaf	[aatχiøχkaf]
thénlébdéèprœn	[θenlebdeɛpχøn]
cholképèd	[ʃolkepɛd]
anf	[ɑ̃f]
agvèkpéanjRénésaékpéuk	[agvɛkpeɑ̃ʒʁenesaekpeyk]
èèblip	[ɛɛblip]
ièbamrégénouboutsaépnamtiinTHuch	[iɛbamχegenubutsaepnamtiinðyʃ]
mTHètkur	[mðɛtkyχ]
ksan	[ksan]
èpaadmanTHét	[ɛpaadmɑ̃ðet]
zèlonn	[zɛlɔ̃n]
œz	[øz]
zèèlœdovour	[zɛɛlødovuχ]
zvoz	[zvoz]
vèannréèlkézaèkèvnœt	[vɛɑ̃nχeɛlkezaɛkɛvnøt]
usnis	[ysnis]
aèbaflonk	[aɛbaflɔ̃k]
égvitkonlnaspasich	[egvitkɔ̃lnaspasiʃ]
lmopèdèaganvdaTH	[lmopɛdɛagɑ̃vdað]
fupraéfsizgopnéRlœs	[fypχaefsizgopneʁløs]
èR	[ɛʁ]
inf	[ɛ̃f]
èRdèdlofmoR	[ɛʁdɛdlofmoʁ]
èskénéRbabaèvRéRgèfnèinrlèbnédlavouk	[ɛskeneʁbabaɛvʁeʁgɛfnɛɛ̃χlɛbnedlavuk]
urœg	[yχøg]
f	[f]
knèiR	[knɛiʁ]
dapfèg	[dapfɛg]
Rvèminrtèchtamian	[ʁvɛmɛ̃χtɛʃtamian]
nrig	[nχig]
jthèTHœfmotèèmivjœtrouf	[ʒθɛðøfmotɛɛmivʒøtχuf]
inakanlégvèœRanèkpad	[ɛ̃akanlegvɛøʁɑ̃ɛkpad]
opsiéz	[opsiez]
ibnionvbèébRéjliœnsouk	[ibniɔ̃vbɛebʁeʒliønsuk]
dthèschonfanéœn	[dθɛsʃɔ̃faneøn]
èoriRaés	[ɛoχiʁaes]
th	[θ]
paapobœvthétréf	[paapobøvθetχef]
af	[af]
rtaf	[χtaf]
sranpéatchanr	[sχanpeatʃɑ̃χ]
lnéœpaèf	[lneøpaɛf]
ustar	[ystaχ]
vaéftémbét	[vaeftembet]
umkinfœgnonrséépisanbzan	[ymkinføgnɔ̃χseepisɑ̃bzan]
anbaatrèch	[ɑ̃baatχɛʃ]
tlonzèRgœd	[tlonzɛʁgød]
onksanR	[ɔ̃ksɑ̃ʁ]
bnorondbénaRgœchsianrkanntèafanadilnamnoun	[bnoχɔ̃dbenaʁgøʃsiɑ̃χkɑ̃ntɛafɑ̃adilnamnun]
odébéèbRof	[odebeɛbʁof]
èj	[ɛʒ]
bnaèflèémivdèflafnèbvor	[bnaɛflɛemivdɛflafnɛbvoχ]
inktéTH	[ɛ̃kteð]
mnid	[mnid]
sèéklègémnichkinchœRènèch	[sɛeklɛgemniʃkɛ̃ʃøʁɛnɛʃ]
èrfénrœpépœchaanr	[ɛχfenχøpepøʃaɑ̃χ]
œbzéléasonTHèsèrèsonmfénméèn	[øbzeleasɔ̃ðɛsɛχɛsɔ̃mfenmeɛn]
thiop	[θiop]
éflinfkuvinsopkodan	[eflɛ̃fkyvɛ̃sopkodan]
éingènouk	[eingɛnuk]
an	[an]
nkoul	[nkul]
onlnètiatonflèRlénraèmfadouRmupœdabanmap	[ɔ̃lnɛtiatɔ̃flɛʁlenχaɛmfaduʁmypødabanmap]
sTHanripchonTHonrnéèltèchrœdiéTH	[sðanχipʃɔ̃ðɔ̃χneɛltɛʃχødieð]
av	[av]
aféontroun	[afeɔ̃tχun]
èéRdœkséTHsanzanthèl	[ɛeʁdøkseðsɑ̃zɑ̃θɛl]
kfaénènchèachank	[kfaenɛnʃɛaʃɑ̃k]
isTHavnœl	[isðavnøl]
trémsaTHkéf	[tχemsaðkef]
kankananbnèégnœr	[kankɑ̃ɑ̃bnɛegnøχ]
fméchlènrimil	[fmeʃlɛnχimil]
apnadimrag	[apnadimχag]
oulat	[ulat]
inRik	[ɛ̃ʁik]
osaétajif	[osaetaʒif]
baanmdènfoufliknithaR	[baɑ̃mdɛnfuflikniθaʁ]
apub	[apyb]
nRodgatlaèrTHèèdmutrangovdéèTHrœrsœs	[nʁodgatlaɛχðɛɛdmytχangovdeɛðχøχsøs]
olchœrèn	[olʃøχɛn]
glamniv	[glamniv]
inzèn	[ɛ̃zɛn]
œjgorèoupizons	[øʒgoχɛupizɔ̃s]
stékéagèébéabos	[stekeagɛebeabos]
œgzinirtèédaRnéf	[øgzɛ̃iχtɛedaʁnef]
déin	[dein]
nféokfét	[nfeokfet]
ounéfkiglètsankonbosœtmolchèlénfifkaèfnakèR	[unefkiglɛtsɑ̃kɔ̃bosøtmolʃɛlenfifkaɛfnakɛʁ]
thifonlèRianm	[θifɔ̃lɛʁiɑ̃m]
kœd	[kød]
sfinp	[sfɛ̃p]
THœvgèzathmavutkiRniinchnakoul	[ðøvgɛzaθmavytkiʁniɛ̃ʃnakul]
œdaédvèchtédéjnéènbèakéœlèg	[ødaedvɛʃtedeʒneɛnbɛakeølɛg]
ourTHab	[uχðab]
dmalégmornéchponprèdarchéronvRéœpnavojépééfkadbanr	[dmalegmoχneʃpɔ̃pχɛdaχʃeχɔ̃vʁeøpnavoʒepeefkadbɑ̃χ]
préétant	[pχeetɑ̃t]
in	[in]
ouvéopéf	[uveopef]
Rnigjénèapnéfnabvathbèanr	[ʁnigʒenɛapnefnabvaθbɛɑ̃χ]
THsép	[ðsep]
orfépraélsonkaf	[oχfepχaelsɔ̃kaf]
monk	[mɔ̃k]
èbéék	[ɛbeek]
éébdaRnonfirkévlajnafafmirpoumnèltééfrup	[eebdaʁnɔ̃fiχkevlaʒnafafmiχpumnɛlteefχyp]
inpnéRèrèoriRépèzég	[ɛ̃pneʁɛχɛoχiʁepɛzeg]
otènRanidonfpédonvébanalrœRnéb	[otɛnʁanidɔ̃fpedonvebɑ̃alχøʁneb]
vananlèplonpsèmrébniètèèRèRégèmubiadRas	[vɑ̃anlɛplɔ̃psɛmχebniɛtɛɛʁɛʁegɛmybiadʁas]
oltièfan	[oltiɛfan]
anchoTHansniljék	[ɑ̃ʃoðɑ̃snilʒek]
ipifrèigdédèf	[ipifχɛigdedɛf]
bakéf	[bakef]
œmpènsèiTHrék	[ømpɛnsɛiðχek]
lœkoubouknanr	[løkubuknɑ̃χ]
gninTHèn	[gninðɛn]
oudouschangèadlèpnaétkèétilfos	[udusʃɑ̃gɛadlɛpnaetkɛetilfos]
aalnanfpènkanj	[aalnɑ̃fpɛnkɑ̃ʒ]
oukléin	[uklein]
iatkèul	[iatkɛyl]
inr	[ɛ̃χ]
nrasonRgisébnèaR	[nχasɔ̃ʁgisebnɛaʁ]
njonRéèbin	[nʒɔ̃ʁeɛbin]
ik	[ik]
dbéTHpinédmœjlangbét	[dbeðpɛ̃edmøʒlɑ̃gbet]
néR	[neʁ]
Rilgèf	[ʁilgɛf]
thèbèétonp	[θɛbɛetɔ̃p]
ubèonndunigdat	[ybɛɔ̃ndynigdat]
onb	[ɔ̃b]
vmonbœzgèinfèongèmkitkifœmnaéfœchkèzultœmséil	[vmɔ̃bøzgɛinfɛɔ̃gɛmkitkifømnaeføʃkɛzyltømseil]
us	[ys]
lèèsèt	[lɛɛsɛt]
chralkœrpèp	[ʃχalkøχpɛp]
œfèafœf	[øfɛaføf]
vnus	[vnys]
gRéèflafkouR	[gʁeɛflafkuʁ]
étfoulrindoRanRmévdéosfœr	[etfulχɛ̃doʁɑ̃ʁmevdeosføχ]
évléonr	[evleɔ̃χ]
dèètkœbnèoul	[dɛɛtkøbnɛul]
œr	[øχ]
anèRmann	[anɛʁmɑ̃n]
énaébichmibèpunzouz	[enaebiʃmibɛpynzuz]
èor	[ɛoχ]
inœn	[ɛ̃øn]
thlaéskénèfritouf	[θlaeskenɛfχituf]
THéthèv	[ðeθɛv]
oTHèrnousonknathbéœjètinvRabzèvjourœsmœTH	[oðɛχnusɔ̃knaθbeøʒɛtɛ̃vʁabzɛvʒuχøsmøð]
œchoral	[øʃoχal]
anlédéoub	[ɑ̃ledeub]
at	[at]
bèf	[bɛf]
thbék	[θbek]
éolrazojlanl	[eolχazoʒlɑ̃l]
èouTHnèoRar	[ɛuðnɛoʁaχ]
krar	[kχaχ]
aèsés	[aɛses]
aès	[aɛs]
okim	[okim]
œnlœfèrinRœglinœbèlanpéésègRam	[ønløfɛχɛ̃ʁøglɛ̃øbɛlanpeesɛgʁam]
inj	[ɛ̃ʒ]
Rnésibéék	[ʁnesibeek]
chrans	[ʃχɑ̃s]
ikpèfnèén	[ikpɛfnɛen]
rpétœndièn	[χpetøndiɛn]
fpéb	[fpeb]
Raanzœprèpungéag	[ʁaɑ̃zøpχɛpyngeag]
kfanninioufnédœklœchsègvaR	[kfɑ̃niniufnedøkløʃsɛgvaʁ]
thaèRjousrairlanRuf	[θaɛʁʒusχaiχlanʁyf]
kripœbath	[kχipøbaθ]
gnonk	[gnɔ̃k]
spèœbèlrœTH	[spɛøbɛlχøð]
ifontchaas	[ifɔ̃tʃaas]
chœchsivéd	[ʃøʃsived]
œrkél	[øχkel]
tènRèouspèm	[tɛnʁɛuspɛm]
ksélchèvanvétkékraatraézèn	[kselʃɛvanvetkekχaatχaezɛn]
pféèdévRœraéRak	[pfeɛdevʁøχaeʁak]
iaTHniribzéanr	[iaðniχibzeɑ̃χ]
zgœkonRéip	[zgøkɔ̃ʁeip]
infar	[ɛ̃faχ]
vninjaagèzgén	[vnɛ̃ʒaagɛzgen]
ébak	[ebak]
anlvèsuz	[ɑ̃lvɛsyz]
rès	[χɛs]
ouvéthléèmkéagascharfiél	[uveθleɛmkeagasʃaχfiel]
rsuRézoR	[χsyʁezoʁ]
slogvaésonTHsil	[slogvaesɔ̃ðsil]
jèètpœfnaégbakœs	[ʒɛɛtpøfnaegbakøs]
réilrèr	[χeilχɛχ]
jgéRœg	[ʒgeʁøg]
Rèènténfégètanl	[ʁɛɛntenfegɛtɑ̃l]
odouf	[oduf]
vœpkajipénènœtarir	[vøpkaʒipenɛnøtaχiχ]
toch	[toʃ]
zanfès	[zɑ̃fɛs]
THèœgnaznaéTHaRnas	[ðɛøgnaznaeðaʁnas]
vnaèpléœpadépaaR	[vnaɛpleøpadepaaʁ]
tférlab	[tfeχlab]
bléèn	[bleɛn]
gan	[gan]
injluftèp	[ɛ̃ʒlyftɛp]
bRèagar	[bʁɛagaχ]
zééltékrèkatésiprèrlèn	[zeeltekχɛkatesipχɛχlɛn]
j	[ʒ]
ink	[ɛ̃k]
vaébnèpopnèg	[vaebnɛpopnɛg]
éévèèdœt	[eevɛɛdøt]
ougdupkondgèdgébvanbélféplak	[ugdypkɔ̃dgɛdgebvɑ̃belfeplak]
oRnèèl	[oʁnɛɛl]
klœr	[kløχ]
THrèabanijanléf	[ðχɛabɑ̃iʒɑ̃lef]
épnadvolchasfafkéchponRukaanaamasronm	[epnadvolʃasfafkeʃpɔ̃ʁykaanaamasχɔ̃m]
nRèn	[nʁɛn]
Rlèipséonbovniknœchatpiiflépkèèfèn	[ʁlɛipseɔ̃bovniknøʃatpiiflepkɛɛfɛn]
œlRianchilkézlair	[ølʁiɑ̃ʃilkezlaiχ]
lrèTHaléth	[lχɛðaleθ]
fèzèalilonbvonmdanékéœrfèén	[fɛzɛalilɔ̃bvɔ̃mdɑ̃ekeøχfɛen]
lchœlak	[lʃølak]
ptap	[ptap]
zbéinpasfètrènsaèmnaansratogvèmèin	[zbeɛ̃pasfɛtχɛnsaɛmnaɑ̃sχatogvɛmɛin]
zirfit	[ziχfit]
dvoulolfaagninchakofréèth	[dvulolfaagnɛ̃ʃakofχeɛθ]
inptidèvèvétréétmœt	[ɛ̃ptidɛvɛvetχeetmøt]
jèvthinp	[ʒɛvθɛ̃p]
pégamlèèsnaéfponbiéljédipnéfous	[pegamlɛɛsnaefpɔ̃bielʒedipnefus]
èRapfiabaséch	[ɛʁapfiabaseʃ]
dœftonsfannèp	[døftɔ̃sfɑ̃nɛp]
kaf	[kaf]
zoufnègthaspésaatmèfadtharèthouRboupœdbakponp	[zufnɛgθaspesaatmɛfadθaχɛθuʁbupødbakpɔ̃p]
jbouk	[ʒbuk]
èdivœr	[ɛdivøχ]
fup	[fyp]
oupèèpnèf	[upɛɛpnɛf]
sfœm	[sføm]
anp	[ɑ̃p]
jlœspérœl	[ʒløspeχøl]
aat	[aat]
anénRèod	[ɑ̃enʁɛod]
émchéoubœRnanbursutmiatfoch	[emʃeubøʁnɑ̃byχsytmiatfoʃ]
zléik	[zleik]
èf	[ɛf]
oulmich	[ulmiʃ]
obnaivzap	[obnaivzap]
kfèilvètpinfondgoulséachpinèlèTH	[kfɛilvɛtpinfɔ̃dgulseaʃpɛ̃ɛlɛð]
danéuréfmœpis	[daneyχefmøpis]
mpiatlakléktèin	[mpiatlaklektɛin]
bRémfièbvèf	[bʁemfiɛbvɛf]
ktéatsougnang	[kteatsugnɑ̃g]
okiaz	[okiaz]
mjéjœniR	[mʒeʒøniʁ]
thèr	[θɛχ]
ourTHinantpinoudoup	[uχðɛ̃ɑ̃tpinudup]
ufpibdokTHér	[yfpibdokðeχ]
œtkipiakniéplalRœthvapréanmpèdgéRéaR	[øtkipiaknieplalʁøθvapχeɑ̃mpɛdgeʁeaʁ]
rér	[χeχ]
thdaarnuvgijonfréRanértérséoR	[θdaaχnyvgiʒɔ̃fχeʁɑ̃eχteχseoʁ]
œspœsèmlèaRmonfaèdil	[øspøsɛmlɛaʁmɔ̃faɛdil]
ouk	[uk]
Rithafsininnakèfnékann	[ʁiθafsɛ̃ɛ̃nakɛfnekɑ̃n]
anpkath	[ɑ̃pkaθ]
anfkaf	[ɑ̃fkaf]
ianfœstanv	[iɑ̃føstɑ̃v]
dandafrapnil	[dandafχapnil]
aTHébéint	[aðebeɛ̃t]
nlakas	[nlakas]
èbvalinkéTHios	[ɛbvalinkeðios]
mdèdRég	[mdɛdʁeg]
ékrébnœk	[ekχebnøk]
on	[on]
fkègav	[fkɛgav]
ontéajbéœnféapuRdèR	[ɔ̃teaʒbeønfeapyʁdɛʁ]
vRojgafpèapœlèk	[vʁoʒgafpɛapølɛk]
èlsontfiasait	[ɛlsɔ̃tfiasait]
éfrèr	[efχɛχ]
ptantraifinèkmaibgévountètonngufougzèlchougandèkfaagègœdéntènfanch	[ptɑ̃tχaifinɛkmaibgevuntɛtɔ̃ngyfugzɛlʃugɑ̃dɛkfaagɛgødentɛnfɑ̃ʃ]
olépkilidékœn	[olepkilidekøn]
ronvèk	[χɔ̃vɛk]
pèbœm	[pɛbøm]
éœgdèéR	[eøgdɛeʁ]
œRod	[øʁod]
ktaik	[ktaik]
onkpan	[ɔ̃kpan]
Rambéèf	[ʁambeɛf]
inètanRnèfkaég	[ɛ̃ɛtɑ̃ʁnɛfkaeg]
Réémdis	[ʁeemdis]
jatpéRnamégièg	[ʒatpeʁnamegiɛg]
onthan	[ɔ̃θan]
onbabondmœjbapén	[ɔ̃babɔ̃dmøʒbapen]
fnèpiTH	[fnɛpið]
ilnér	[ilneχ]
chnach	[ʃnaʃ]
up	[yp]
œrkœglond	[øχkøglɔ̃d]
œTHmènélfèazbèouv	[øðmɛnelfɛazbɛuv]
ndouniznékèd	[nduniznekɛd]
chréil	[ʃχeil]
maét	[maet]
mkirtagaiRnaégéfib	[mkiχtagaiʁnaegefib]
slèèrértégbiran	[slɛɛχeχtegbiχan]
thamèont	[θamɛɔ̃t]
lnép	[lnep]
œfèn	[øfɛn]
zètchèpkéolonmuzonaél	[zɛtʃɛpkeolɔ̃myzonael]
inninz	[ɛ̃nɛ̃z]
théd	[θed]
thinafap	[θinafap]
mkéégéjunœpnaitsinès	[mkeegeʒynøpnaitsɛ̃ɛs]
jèr	[ʒɛχ]
mvèrlœg	[mvɛχløg]
praètmèœpèvianchrèindarpén	[pχaɛtmɛøpɛviɑ̃ʃχɛɛ̃daχpen]
spanèpénTHodRiéRnik	[spɑ̃ɛpenðodʁieʁnik]
bnichkédjangœférèour	[bniʃkedʒɑ̃gøfeχɛuχ]
zèvountabnationamloud	[zɛvuntabnationamlud]
lsinétsontkuRdafarit	[lsɛ̃etsɔ̃tkyʁdafaχit]
bèpéonrméifanèf	[bɛpeɔ̃χmeifɑ̃ɛf]
anthminbamougikponk	[ɑ̃θmɛ̃bamugikpɔ̃k]
nilvamiglaèrémfaèngéœr	[nilvamiglaɛχemfaɛngeøχ]
antabiœr	[ɑ̃tabiøχ]
RdénRizan	[ʁdenʁizan]
THpèpoutTHégmék	[ðpɛputðegmek]
mvèRlipléaRmèv	[mvɛʁlipleaʁmɛv]
éétanTH	[eetɑ̃ð]
nèaponbaèfchéndinpégRœthéaktéœpéèn	[nɛaponbaɛfʃendɛ̃pegʁøθeakteøpeɛn]
dèdRougœnolémbénpèœpaflèt	[dɛdʁugønolembenpɛøpaflɛt]
kiufril	[kiyfχil]
snoukmatfam	[snukmatfam]
RlanRéantmiourchèrtut	[ʁlɑ̃ʁeɑ̃tmiuχʃɛχtyt]
ons	[ɔ̃s]
zliklot	[zliklot]
optékéat	[optekeat]
usout	[ysut]
THléfam	[ðlefam]
osèèchisièpév	[osɛɛʃisiɛpev]
chonrfélRèr	[ʃɔ̃χfelʁɛχ]
tidid	[tidid]
uchrantsanés	[yʃχɑ̃tsɑ̃es]
chléchéR	[ʃleʃeʁ]
onschounianbnuRaigvèirtèp	[ɔ̃sʃuniɑ̃bnyʁaigvɛiχtɛp]
mpoch	[mpoʃ]
uR	[yʁ]
oboum	[obum]
énsonnènkidopèèdèkéèris	[ensɔ̃nɛnkidopɛɛdɛkeɛχis]
tpiilkéupléRganèbRach	[tpiilkeypleʁgɑ̃ɛbʁaʃ]
vlœbér	[vløbeχ]
Rzif	[ʁzif]
och	[oʃ]
anévèakréavRadRèpsaéfœlmœtsapif	[ɑ̃evɛakχeavʁadʁɛpsaefølmøtsapif]
nœRnéviadèéviastaniRmébgiraavthèr	[nøʁneviadɛeviastɑ̃iʁmebgiχaavθɛχ]
rchinjoubionjzématéœm	[χʃɛ̃ʒubiɔ̃ʒzemateøm]
rnéanpnèkpatchèprèètèédanif	[χneɑ̃pnɛkpatʃɛpχɛɛtɛedɑ̃if]
utfén	[ytfen]
éapchoul	[eapʃul]
œl	[øl]
œfmonf	[øfmɔ̃f]
kpoglérouzav	[kpogleχuzav]
sféchtik	[sfeʃtik]
ingléach	[ɛ̃gleaʃ]
rtèpriraTHkonn	[χtɛpχiχaðkɔ̃n]
inœk	[ɛ̃øk]
lvonmonbRanchrujRonlèdœltonpkuRnœntépépnèlœn	[lvɔ̃mɔ̃bʁɑ̃ʃχyʒʁonlɛdøltɔ̃pkyʁnøntepepnɛløn]
igilinidèèRthagmér	[igilinidɛɛʁθagmeχ]
rméRdèonrœvnanatchasnéèr	[χmeʁdɛonχøvnɑ̃atʃasneɛχ]
skéop	[skeop]
ourkér	[uχkeχ]
tébnèach	[tebnɛaʃ]
thopadonp	[θopadɔ̃p]
dRan	[dʁan]
otiR	[otiʁ]
èz	[ɛz]
gthèlukrilœftanpèrmèèmèRzof	[gθɛlykχiløftɑ̃pɛχmɛɛmɛʁzof]
ptak	[ptak]
anvméènonrèmchumindéat	[ɑ̃vmeɛnɔ̃χɛmʃymɛ̃deat]
spèn	[spɛn]
baèlRonf	[baɛlʁɔ̃f]
ounropnit	[unχopnit]
képérouth	[kepeχuθ]
vnanpœn	[vnanpøn]
bRérnif	[bʁeχnif]
épélèéRgul	[epelɛeʁgyl]
lub	[lyb]
outinmértabèbRéfnéakranap	[utinmeχtabɛbʁefneakχɑ̃ap]
RvékrinèogédéèTHkèadgœmèm	[ʁvekχinɛogedeɛðkɛadgømɛm]
oufèrkof	[ufɛχkof]
mgèpchanf	[mgɛpʃɑ̃f]
npéèn	[npeɛn]
évoténéutlachééthmous	[evoteneytlaʃeeθmus]
bun	[byn]
imaf	[imaf]
stœtoufTHèr	[støtufðɛχ]
thairinf	[θaiχɛ̃f]
zlaptidèantmap	[zlaptidɛɑ̃tmap]
onRœf	[onʁøf]
ontaf	[ɔ̃taf]
rol	[χol]
safnérœsrangœbubanRlèsaér	[safneχøsχɑ̃gøbybɑ̃ʁlɛsaeχ]
anès	[ɑ̃ɛs]
fror	[fχoχ]
éjninèth	[eʒninɛθ]
thiprèosatfèb	[θipχɛosatfɛb]
inad	[ɛ̃ad]
lèajRéanton	[lɛaʒʁeɑ̃ton]
thlévdaptam	[θlevdaptam]
bRœroutréljaavonbaèkèép	[bʁøχutχelʒaavɔ̃baɛkɛep]
sak	[sak]
kèinb	[kɛɛ̃b]
ol	[ol]
bigul	[bigyl]
nvèbonthétanl	[nvɛbɔ̃θetɑ̃l]
sèèknonsnifès	[sɛɛknɔ̃snifɛs]
znéptich	[zneptiʃ]
om	[om]
œnaèn	[ønaɛn]
zRanann	[zʁɑ̃ɑ̃n]
mvéounfur	[mveunfyχ]
nénthèat	[nenθɛat]
ouRnœl	[uʁnøl]
rœr	[χøχ]
bnœnèiv	[bnønɛiv]
THnon	[ðnon]
minf	[mɛ̃f]
banRmaèkinlmondRègmistonfumrék	[bɑ̃ʁmaɛkɛ̃lmɔ̃dʁɛgmistɔ̃fymχek]
ktubannoupsœb	[ktybɑ̃nupsøb]
anéRèœvnéanr	[ɑ̃eʁɛøvneɑ̃χ]
dvik	[dvik]
ènminpœmséftœfkœk	[ɛnminpømseftøfkøk]
éptéfnéikann	[eptefneikɑ̃n]
tlantéchanémréid	[tlanteʃɑ̃emχeid]
gèonch	[gɛɔ̃ʃ]
far	[faχ]
vRanfchèèr	[vʁɑ̃fʃɛɛχ]
chionprèmaflirpèntudthèèzègèœdbèouranonkèèrérfann	[ʃiɔ̃pχɛmafliχpɛntydθɛɛzɛgɛødbɛuχanɔ̃kɛɛχeχfɑ̃n]
anèsananf	[ɑ̃ɛsɑ̃ɑ̃f]
saéRmœm	[saeʁmøm]
monkiétœléchrantœknafkan	[mɔ̃kietøleʃχantøknafkan]
blœf	[bløf]
bvak	[bvak]
THoninTHchonsmézèapinèmgap	[ðonɛ̃ðʃɔ̃smezɛapɛ̃ɛmgap]
mouRémtéèkfépkèrsarnéèl	[muʁemteɛkfepkɛχsaχneɛl]
troramthéœRœnés	[tχoχamθeøʁønes]
bèRadgœp	[bɛʁadgøp]
indéf	[ɛ̃def]
onrfiTHœvdœblèém	[ɔ̃χfiðøvdøblɛem]
onthzèr	[ɔ̃θzɛχ]
THmèas	[ðmɛas]
tmèsukfovlikœrminridvonvgèRnézèchaikèTHtonrnaznœt	[tmɛsykfovlikøχminχidvɔ̃vgɛʁnezɛʃaikɛðtɔ̃χnaznøt]
bènpasaf	[bɛnpasaf]
zninnkanfétouchéès	[znɛ̃nkɑ̃fetuʃeɛs]
Rœnék	[ʁønek]
iaktin	[iaktin]
umagonr	[ymagɔ̃χ]
chaédœrséœj	[ʃaedøχseøʒ]
thif	[θif]
œd	[ød]
mnongmèfkéanvèrfuplaf	[mnɔ̃gmɛfkeanvɛχfyplaf]
ronrlonktœpiféaknil	[χɔ̃χlɔ̃ktøpifeaknil]
riés	[χies]
déz	[dez]
éèponslèœr	[eɛpɔ̃slɛøχ]
ktèngœv	[ktɛngøv]
éalchéthaés	[ealʃeθaes]
THsaf	[ðsaf]
vjèèR	[vʒɛɛʁ]
chèéf	[ʃɛef]
œngavnœRéjapkang	[øngavnøʁeʒapkɑ̃g]
éz	[ez]
ngangiœmbèch	[ngɑ̃giømbɛʃ]
nkan	[nkan]
ébgèfès	[ebgɛfɛs]
anèbafsuRgarpaazibuvév	[ɑ̃ɛbafsyʁgaχpaazibyvev]
mangRèTHtitan	[mɑ̃gʁɛðtitan]
èœbiélrich	[ɛøbielχiʃ]
nœrnalkaèch	[nøχnalkaɛʃ]
sèsninapnéidbout	[sɛsnɛ̃apneidbut]
rénif	[χenif]
chlènsom	[ʃlɛnsom]
œlmèèn	[ølmɛɛn]
rléknék	[χleknek]
ant	[ɑ̃t]
anchèg	[ɑ̃ʃɛg]
ièglèépèn	[iɛglɛepɛn]
sriRlèRaèr	[sχiʁlɛʁaɛχ]
Réonzouchèéréinfœrèntiodonrnék	[ʁeɔ̃zuʃɛeχeinføχɛntiodɔ̃χnek]
él	[el]
oulkon	[ulkon]
véénfèar	[veenfɛaχ]
vdaRgathanrantifréigiir	[vdaʁgaθɑ̃χɑ̃tifχeigiiχ]
œjthanouf	[øʒθanuf]
tmad	[tmad]
blénchééskarsonrchèn	[blenʃeeskaχsɔ̃χʃɛn]
onz	[ɔ̃z]
éR	[eʁ]
bgèRgainbaRbœm	[bgɛʁgaɛ̃baʁbøm]
vèp	[vɛp]
ufènmikrœlnœn	[yfɛnmikχølnøn]
nfaèslas	[nfaɛslas]
lmép	[lmep]
déRèR	[deʁɛʁ]
bzanèlfigvésaèrélRœf	[bzɑ̃ɛlfigvesaɛχelʁøf]
inalaèvnèsfonlgaéTHaaRlènsip	[ɛ̃alaɛvnɛsfɔ̃lgaeðaaʁlɛnsip]
anlotkèémsitfèlkéègadèmRaRnoligul	[ɑ̃lotkɛemsitfɛlkeɛgadɛmʁaʁnoligyl]
plid	[plid]
dét	[det]
inèchann	[ɛ̃ɛʃɑ̃n]
èdbél	[ɛdbel]
onR	[ɔ̃ʁ]
jéét	[ʒeet]
fnioup	[fniup]
dam	[dam]
èinp	[ɛɛ̃p]
œgnoRnèrtaéRakmag	[øgnoʁnɛχtaeʁakmag]
RnorfarchiérTHèch	[ʁnoχfaχʃieχðɛʃ]
chtonchkouRanR	[ʃtɔ̃ʃkuʁɑ̃ʁ]
ftœftonmaanvéR	[ftøftɔ̃maɑ̃veʁ]
opféévèn	[opfeevɛn]
bogladzén	[bogladzen]
orkèid	[oχkɛid]
zdonfèbthid	[zdɔ̃fɛbθid]
kminéb	[kmɛ̃eb]
onlkanR	[ɔ̃lkɑ̃ʁ]
gnastéf	[gnastef]
id	[id]
slèRmég	[slɛʁmeg]
THèTHfoupœtriongoupœTHchémlachochféspièm	[ðɛðfupøtχiɔ̃gupøðʃemlaʃoʃfespiɛm]
tèap	[tɛap]
thosiénèagolèét	[θosienɛagolɛet]
plantontpœrkank	[plɑ̃tɔ̃tpøχkɑ̃k]
thoutkouk	[θutkuk]
il	[il]
anfèènèœthlonpiérchœl	[ɑ̃fɛɛnɛøθlɔ̃pieχʃøl]
ar	[aχ]
chnénés	[ʃnenes]
THnonRdènchaanz	[ðnɔ̃ʁdɛnʃaɑ̃z]
ot	[ot]
fkad	[fkad]
lTHatéèbanènoufrichranRlaér	[lðateɛbɑ̃ɛnufχiʃχɑ̃ʁlaeχ]
inftœlgonR	[ɛ̃ftølgɔ̃ʁ]
az	[az]
ourouRér	[uχuʁeχ]
évnœr	[evnøχ]
onvapœrœdodék	[ɔ̃vapøχødodek]
THchèœnlèésanèfakikséinvananfonmtouprœdafTHaabètéèsalkanrnèrchèouskonRnanav	[ðʃɛønlɛesɑ̃ɛfakikseɛ̃vanɑ̃fɔ̃mtupχødafðaabɛteɛsalkɑ̃χnɛχʃɛuskɔ̃ʁnɑ̃av]
ronbéuch	[χɔ̃beyʃ]
éngémdétémèljés	[engemdetemɛlʒes]
rlobdirmik	[χlobdiχmik]
zéb	[zeb]
ontiachnaiTHpéidipèpèmgéRdivnènaèbdinp	[ɔ̃tiaʃnaiðpeidipɛpɛmgeʁdivnɛnaɛbdɛ̃p]
Rénonrinf	[ʁenɔ̃χɛ̃f]
éonf	[eɔ̃f]
ilzafarchènkankrœp	[ilzafaχʃɛnkɑ̃kχøp]
dmédannkag	[dmedɑ̃nkag]
onmgèl	[ɔ̃mgɛl]
sèch	[sɛʃ]
féathènmour	[feaθɛnmuχ]
nfértékénbékrèèn	[nfeχtekenbekχɛɛn]
rémdèl	[χemdɛl]
iRjœmféch	[iʁʒømfeʃ]
œvRœpouf	[øvʁøpuf]
éTHoupnanTHpouvnœléid	[eðupnɑ̃ðpuvnøleid]
ourèlèn	[uχɛlɛn]
mop	[mop]
fkont	[fkɔ̃t]
éurmél	[eyχmel]
RanlnonTH	[ʁɑ̃lnɔ̃ð]
vaplutsèèn	[vaplytsɛɛn]
inRnèdzèm	[ɛ̃ʁnɛdzɛm]
kpéréons	[kpeχeɔ̃s]
gthététTHaar	[gθetetðaaχ]
inésouprèortép	[ɛ̃esupχɛoχtep]
mbour	[mbuχ]
mœstèrœmvouz	[møstɛχømvuz]
oug	[ug]
œpkaaf	[øpkaaf]
uchsèèthniélsènRéarkarœpforirkagaèRmèp	[yʃsɛɛθnielsɛnʁeaχkaχøpfoχiχkagaɛʁmɛp]
inchinépnéèr	[ɛ̃ʃɛ̃epneɛχ]
frinèfponfèadmougatpèglèkoubèzdèbnœRœfséanmabœgém	[fχɛ̃ɛfpɔ̃fɛadmugatpɛglɛkubɛzdɛbnøʁøfseanmabøgem]
fad	[fad]
gonninRœmninéèséTHféèn	[gɔ̃ninʁømnineɛseðfeɛn]
thabléœtalavèœk	[θableøtalavɛøk]
gdifpélkèètkèf	[gdifpelkɛɛtkɛf]
THchékagèr	[ðʃekagɛχ]
mkém	[mkem]
oud	[ud]
bèbjèabdolréond	[bɛbʒɛabdolχeɔ̃d]
èg	[ɛg]
THanaj	[ðanaʒ]
intiRmaRlavmœrètèongéTH	[ɛ̃tiʁmaʁlavmøχɛtɛɔ̃geð]
èkudèœsong	[ɛkydɛøsɔ̃g]
ounénlurak	[unenlyχak]
fkan	[fkan]
zésop	[zesop]
Rnèafkééschuvœm	[ʁnɛafkeesʃyvøm]
ofnonk	[ofnɔ̃k]
RèkérfoTHak	[ʁɛkeχfoðak]
méch	[meʃ]
oulith	[uliθ]
mnamchénévéik	[mnamʃeneveik]
ifnéch	[ifneʃ]
tèpnidéTHiz	[tɛpnideðiz]
laèrfèmlanèboufèœmbèlœm	[laɛχfɛmlanɛbufɛømbɛløm]
uRontiènlèr	[yʁɔ̃tiɛnlɛχ]
èiRapéœdél	[ɛiʁapeødel]
THfor	[ðfoχ]
bètonr	[bɛtɔ̃χ]
mkonœd	[mkonød]
œmchœfœdanbounvaègvanéRnèar	[ømʃøfødɑ̃bunvaɛgvɑ̃eʁnɛaχ]
chnékmèzèRthurém	[ʃnekmɛzɛʁθyχem]
zabanftèor	[zabɑ̃ftɛoχ]
nfimjènréb	[nfimʒɛnχeb]
okchap	[okʃap]
knaf	[knaf]
naèplakibliéthènzéanjésézatèinf	[naɛplakiblieθɛnzeɑ̃ʒesezatɛɛ̃f]
rabiouminnrouslisnaèp	[χabiumɛ̃nχuslisnaɛp]
os	[os]
aép	[aep]
mrèkais	[mχɛkais]
krèèRniruthliémchalouchèg	[kχɛɛʁniχyθliemʃaluʃɛg]
rlonf	[χlɔ̃f]
nianchalroTH	[niɑ̃ʃalχoð]
ondbètrinipfas	[ɔ̃dbɛtχɛ̃ipfas]
èt	[ɛt]
antpètounrapranrnalcholandviréèlonkounkaanlraadviènvénféfaégnivœk	[ɑ̃tpɛtunχapχɑ̃χnalʃolɑ̃dviχeɛlɔ̃kunkaɑ̃lχaadviɛnvenfefaegnivøk]
kiéTH	[kieð]
onnmonTHléfénag	[ɔ̃nmɔ̃ðlefenag]
bonf	[bɔ̃f]
dinvnif	[dɛ̃vnif]
gib	[gib]
lbèfkifTHœs	[lbɛfkifðøs]
dgafaévbus	[dgafaevbys]
kékugélbachtéischigéslianraf	[kekygelbaʃteisʃigesliɑ̃χaf]
iour	[iuχ]
Réch	[ʁeʃ]
ouvod	[uvod]
piltèchtèRnan	[piltɛʃtɛʁnan]
gdonrèanvlètébthép	[gdɔ̃χɛɑ̃vlɛtebθep]
èvdurarpèf	[ɛvdyχaχpɛf]
upséén	[ypseen]
tazièch	[taziɛʃ]
RnabduRnogéviégvépangab	[ʁnabdyʁnogeviegvepɑ̃gab]
rèéRjéRum	[χɛeʁʒeʁym]
vgiœfanvanaglèbapnavRérouch	[vgiøfɑ̃vanaglɛbapnavʁeχuʃ]
mfikéat	[mfikeat]
doufanrtœpétsééth	[dufɑ̃χtøpetseeθ]
rsènum	[χsɛnym]
udéf	[ydef]
rlaankéjnèRèrfach	[χlaankeʒnɛʁɛχfaʃ]
bézvonbœRnœnlivRotrionféparalas	[bezvɔ̃bøʁnønlivʁotχiɔ̃fepaχalas]
nkainpkupnapnédgipfonpaf	[nkaɛ̃pkypnapnedgipfonpaf]
chlagzèr	[ʃlagzɛχ]
itchègœnRipinréjéthéatépiébRétatèbinp	[itʃɛgønʁipɛ̃χeʒeθeatepiebʁetatɛbɛ̃p]
néd	[ned]
zniaRnèp	[zniaʁnɛp]
osas	[osas]
ambél	[ambel]
dbanninav	[dbɑ̃ninav]
tTHœdgèrnonléf	[tðødgɛχnɔ̃lef]
éonp	[eɔ̃p]
faftéizan	[fafteizan]
éèchfèsfèétkéonf	[eɛʃfɛsfɛetkeɔ̃f]
mzak	[mzak]
zlachmoutchadénèR	[zlaʃmutʃadenɛʁ]
omnok	[omnok]
thaR	[θaʁ]
ongèklanèfmœRiv	[ɔ̃gɛklɑ̃ɛfmøʁiv]
jiiTHiléiTHliamganaTH	[ʒiiðileiðliamgɑ̃að]
ksoutan	[ksutan]
ouj	[uʒ]
knabœnbaèkfaèsèèch	[knabønbaɛkfaɛsɛɛʃ]
vép	[vep]
inèplinèzœRaénRœbthééRzèifniép	[ɛ̃ɛplinɛzøʁaenʁøbθeeʁzɛifniep]
lignébaadapèkTHugèévniktévdœdbémtachfanf	[lignebaadapɛkðygɛevniktevdødbemtaʃfɑ̃f]
inpéfpèébœnsélTHéœknérèrpèrif	[ɛ̃pefpɛebønselðeøkneχɛχpɛχif]
mœTH	[møð]
gonftéakibèplèntèarTHèr	[gɔ̃fteakibɛplɛntɛaχðɛχ]
bthaènchasnèuplach	[bθaɛnʃasnɛyplaʃ]
chtèaf	[ʃtɛaf]
vongirèip	[vɔ̃giχɛip]
inistaarnèfakrèpir	[ɛ̃istaaχnɛfakχɛpiχ]
THkèsrit	[ðkɛsχit]
nsœchnèb	[nsøʃnɛb]
bœmagèbinoRéèR	[bømagɛbɛ̃oʁeɛʁ]
futloufkèR	[fytlufkɛʁ]
èétfiakébandad	[ɛetfiakebɑ̃dad]
THtœnèdègvém	[ðtønɛdɛgvem]
knéonjènéfnalsanpkaj	[kneɔ̃ʒɛnefnalsɑ̃pkaʒ]
agaandvèn	[agaɑ̃dvɛn]
iœbRoud	[iøbʁud]
bouTHkabœglènéTHpaRoun	[buðkabøglɛneðpaʁun]
mrœRaRosrœdRœkèrfètanazgés	[mχøʁaʁosχødʁøkɛχfɛtɑ̃azges]
ious	[ius]
fchondiRus	[fʃɔ̃diʁys]
prétèl	[pχetɛl]
maakurtaRvéftèblélép	[maakyχtaʁveftɛblelep]
nanl	[nɑ̃l]
azlénkéèr	[azlenkeɛχ]
pun	[pyn]
ogbéRoktègaf	[ogbeʁoktɛgaf]
œbéthRinl	[øbeθʁɛ̃l]
œrénaRakaésrèéRnopiak	[øχenaʁakaesχɛeʁnopiak]
jin	[ʒin]
onr	[ɔ̃χ]
sTHiléfouboutémèlannarpanrség	[sðilefubutemɛlɑ̃naχpɑ̃χseg]
unbit	[ynbit]
anilèth	[ɑ̃ilɛθ]
èzgoulér	[ɛzguleχ]
œsnièbanrènvèar	[øsniɛbanχɛnvɛaχ]
aif	[aif]
ntil	[ntil]
inok	[ɛ̃ok]
bœkfiifkés	[bøkfiifkes]
THmoutléèmafmèbim	[ðmutleɛmafmɛbim]
THéaktonbgéèl	[ðeaktɔ̃bgeɛl]
œnTHiétkiadéèch	[ønðietkiadeɛʃ]
èlaésok	[ɛlaesok]
chomnouRgopataèfonplèrfèlfaénsééf	[ʃomnuʁgopataɛfɔ̃plɛχfɛlfaenseef]
thènèkérfaègœthjanémtantœléèravanzonchpaninf	[θɛnɛkeχfaɛgøθʒɑ̃emtantøleɛχavɑ̃zɔ̃ʃpɑ̃ɛ̃f]
iœziéR	[iøzieʁ]
gègatongnakfaRiinéouk	[gɛgatɔ̃gnakfaʁiineuk]
zmusikannèblapémrèlachoubavèaklinanréR	[zmysikɑ̃nɛblapemχɛlaʃubavɛaklɛ̃ɑ̃χeʁ]
THisfaiznénfaiRèjéfchèédœgaamlournèas	[ðisfaiznenfaiʁɛʒefʃɛedøgaamluχnɛas]
ichsin	[iʃsin]
ankpèlninznœnbœb	[ɑ̃kpɛlnɛ̃znønbøb]
thaziéntéœlkèpint	[θazienteølkɛpɛ̃t]
rèdbéébèR	[χɛdbeebɛʁ]
ftor	[ftoχ]
inodRœn	[ɛ̃odʁøn]
onp	[ɔ̃p]
figachèlkanavRak	[figaʃɛlkɑ̃avʁak]
èrtaR	[ɛχtaʁ]
irchérlèrékaRounogis	[iχʃeχlɛχekaʁunogis]
Raf	[ʁaf]
chfèch	[ʃfɛʃ]
chrèchlontsoubvatlaantibnatèprèonm	[ʃχɛʃlɔ̃tsubvatlaantibnatɛpχɛɔ̃m]
tirèr	[tiχɛχ]
uv	[yv]
vœR	[vøʁ]
lfèmés	[lfɛmes]
ènal	[ɛnal]
mnublil	[mnyblil]
tléRgèèz	[tleʁgɛɛz]
fkiasnèchpéongiksœp	[fkiasnɛʃpeɔ̃giksøp]
tfièl	[tfiɛl]
ailnèrsanèl	[ailnɛχsɑ̃ɛl]
naèj	[naɛʒ]
onRant	[ɔ̃ʁɑ̃t]
THokarTHinèptougnénronbnésaanmlichnér	[ðokaχðɛ̃ɛptugnenχɔ̃bnesaɑ̃mliʃneχ]
lnœTH	[lnøð]
ronrèaRgor	[χɔ̃χɛaʁgoχ]
anchléoulronvègévoufaèk	[ɑ̃ʃleulχɔ̃vɛgevufaɛk]
éf	[ef]
séonR	[seɔ̃ʁ]
œRèsfinfiœchinklanèr	[øʁɛsfɛ̃fiøʃɛ̃klɑ̃ɛχ]
ifèkèmchèr	[ifɛkɛmʃɛχ]
sfitath	[sfitaθ]
fonn	[fɔ̃n]
